#domain
hospital22
#levelname
SAFriendOfBFS
#colors
blue:0,A,B,C
#initial
+++++++++++++++++++
+0                +
+                 +
+                 +
+                 +
+                 +
+                 +
+       A         +
+                 +
+                 +
+                 +
+                 +
+                 +
+                 +
+++++++++++++++++++
#goal
+++++++++++++++++++
+0                +
+                 +
+                 +
+                 +
+                 +
+                 +
+        A        +
+                 +
+                 +
+                 +
+                 +
+                 +
+                 +
+++++++++++++++++++
#end
