#domain
hospital2
#levelname
SAgroup
#colors
red: 0, A
#initial
+++++++++++++++++++++++++++++++++++++++++++++++++
+             +       +   +       +             +  
+ +++++++++++ + +++++ + + + +++++ + +++++++++++ +
+ +           + +   + + + + +   + +           + +
+ + +++++++++++ + + + + + + + + + +++++++++++ + +    
+ +             + + + + + + + + +           + + +
+ +++++++++++++++ + +   +   + + +++++++++++ + + +
+ +               + +++++++++ +             + + +
+ + +++++++++++++++ +       + +++++++++++++++ + +
+ +     +           + +++++ +           +     + +
+ +++++ + +++++++++++ +   + +++++++++++ + +++++ +
+     + + +           + + +           + + +     +
+++++ + + + +++++++++++ + +++++++++++ + + + +++++
+     + + + +      +    +    +      + + + +     +
+ +++++ + + + ++++ + +++++++ + ++++ + + + +++++ +
+ +     + + + +    +    +    +    + + + +     + +
+ + +++++ + + + +++++++ + +++++++ + + + +++++ + +
+ + +     + + + +       +       + + + +     + + +
+ + + +++++ + + + +++++++++++++ + + + +++++ + + +
+ + +       + + + +     +     + + + + +     + + +
+ + +++++++++ + + + +++ + +++ + + + + + +++++ + +
+ +     +     +   + +   +   +   + +   + +     + +
+ +++++ + +++++++++ + +++++ +++++ +++++ + +++++ +
+     + +     +     + +   + +     +     + +     +
+++++ + +++++ + +++++ ++A++ + +++++ +++++ + +++++
+     + +     +     + +AAA+ +     +     + +     +
+ +++++ + +++++++++ + ++ ++ +++++ +++++ + +++++ +
+ +     +     +   + +  + +  +   + +   + +     + +
+ + +++++++++ + + + ++ + + ++ + + + + + +++++ + +
+ + +       + + + +  + + +    + + + + +     + + +
+ + + +++++ + + + ++ + + ++++++ + + + +++++ + + +
+ + +     + + + +    + +    +   + + + +     + + +
+ + +++++ + + + ++++++ ++++ + +++ + + + +++++ + +
+ +     + + + +      + +    +     + + + +     + +
+ +++++ + + + ++++++ + + ++++++++++ + + + +++++ +
+     + + + +        + +            + + + +     +
+++++ + + + ++++++++++ ++++++++++++++ + + + +++++
+     + + +            + +      +     + + +     +
+ +++++ + ++++++++++++++++ ++++ + +++++ + +++++ +
+ +     +        +       + +    +     + +     + +
+ + ++++++++++++ + +++++ + + ++++++++ + +++++ + +
+ +        +     +     + + +     +    +     + + +
+ ++++++++ + +++++++++ + + +++++ + ++++++++ + + +
+ +        +     +     + + +     +    +     + + +
+ + ++++++++++++ + +++++ + + ++++++++ + +++++ + +
+ +        +     +     + + +          +       + +
+ ++++++++ + +++++++++ + + + ++++++++++++++++++ +
+          +           +0+ +                    +
+++++++++++++++++++++++++++++++++++++++++++++++++
#goal
+++++++++++++++++++++++++++++++++++++++++++++++++
+             +       +   +       +             +  
+ +++++++++++ + +++++ + + + +++++ + +++++++++++ +
+ +           + +   + + + + +   + +           + +
+ + +++++++++++ + + + + + + + + + +++++++++++ + +    
+ +             + + + + + + + + +           + + +
+ +++++++++++++++ + +   +   + + +++++++++++ + + +
+ +               + +++++++++ +             + + +
+ + +++++++++++++++ +       + +++++++++++++++ + +
+ +     +           + +++++ +           +     + +
+ +++++ + +++++++++++ +   + +++++++++++ + +++++ +
+     + + +           + + +           + + +     +
+++++ + + + +++++++++++ + +++++++++++ + + + +++++
+     + + + +      +    +    +      + + + +     +
+ +++++ + + + ++++ + +++++++ + ++++ + + + +++++ +
+ +     + + + +    +    +    +    + + + +     + +
+ + +++++ + + + +++++++ + +++++++ + + + +++++ + +
+ + +     + + + +       +       + + + +     + + +
+ + + +++++ + + + +++++++++++++ + + + +++++ + + +
+ + +       + + + +     +     + + + + +     + + +
+ + +++++++++ + + + +++ + +++ + + + + + +++++ + +
+ +     +     +   + +   +   +   + +   + +     + +
+ +++++ + +++++++++ + +++++ +++++ +++++ + +++++ +
+     + +     +     + +A A+ +     +     + +     +
+++++ + +++++ + +++++ ++ ++ + +++++ +++++ + +++++
+     + +     +     + +   + +     +     + +     +
+ +++++ + +++++++++ + ++ ++ +++++ +++++ + +++++ +
+ +     +     +   + +  + +  +   + +   + +     + +
+ + +++++++++ + + + ++ + + ++ + + + + + +++++ + +
+ + +       + + + +  + + +    + + + + +     + + +
+ + + +++++ + + + ++ + + ++++++ + + + +++++ + + +
+ + +     + + + +    + +    +   + + + +     + + +
+ + +++++ + + + ++++++ ++++ + +++ + + + +++++ + +
+ +     + + + +      + +    +     + + + +     + +
+ +++++ + + + ++++++ + + ++++++++++ + + + +++++ +
+     + + + +        + +            + + + +     +
+++++ + + + ++++++++++ ++++++++++++++ + + + +++++
+     + + +            + +      +     + + +     +
+ +++++ + ++++++++++++++++ ++++ + +++++ + +++++ +
+ +     +        +       + +    +     + +     + +
+ + ++++++++++++ + +++++ + + ++++++++ + +++++ + +
+ +        +     +     + + +     +    +     + + +
+ ++++++++ + +++++++++ + + +++++ + ++++++++ + + +
+ +        +     +     + + +     +    +     + + +
+ + ++++++++++++ + +++++ + + ++++++++ + +++++ + +
+ +        +     +     + + +          +       + +
+ ++++++++ + +++++++++ + + + ++++++++++++++++++ +
+          +           + + +                    +
+++++++++++++++++++++++++++++++++++++++++++++++++
#end
