#domain
hospital2
#levelname
SAMKM
#colors
red:0,A
#initial
+++++++++++++++++++++++++++
+                         +
+ +++++++++++++++++++++++ +
+                       + +
+                       + +
+                       + +
+                       + +
+                       + +
+                       + +
+                       + +
+                     A0+ +
+++++++++++++++++++++++++++
#goal
+++++++++++++++++++++++++++
+                         +
+ +++++++++++++++++++++++ +
+                       + +
+                       + +
+                       + +
+                       + +
+                       + +
+                       + +
+                       + +
+                      0+A+
+++++++++++++++++++++++++++
#end
