#domain
hospital2
#levelname
SAMKM
#colors
red:0,A,B,C
#initial
+++++++++++++++++++++++++++
+                         +
+ ++++++++ ++++++ +++  ++ +
+                       + +
+                       + +
+                       + +
+                       + +
+                       + +
+                       + +
+                     B + +
+                    CA0+ +
+++++++++++++++++++++++++++
#goal
+++++++++++++++++++++++++++
+                         +
+ ++++++++ ++++++ +++  ++ +
+                       + +
+                       + +
+                       + +
+                       + +
+                       + +
+                       +C+
+                       +B+
+                      0+A+
+++++++++++++++++++++++++++
#end
