#domain
hospital2
#levelname
SAMKM
#colors
red:0,A,B,C
#initial
+++++++++++++++++++++++++++
+                         +
+ +++++++++++++++++++++++ +
+                       + +
+                       + +
+                       + +
+                       + +
+                       + +
+                     C + +
+                     B + +
+                     A0+ +
+++++++++++++++++++++++++++
#goal
+++++++++++++++++++++++++++
+                         +
+ +++++++++++++++++++++++ +
+                       + +
+                       + +
+                       + +
+                       + +
+                       + +
+                       +C+
+                       +B+
+                       +A+
+++++++++++++++++++++++++++
#end
