#domain
hospital2
#levelname
Obvious5
#colors
Blue:0,A
#initial
++++++++++
+        +
+        +
+        +
+0      A+
++++++++++
#goal
++++++++++
+       A+
+       0+
+        +
+        +
++++++++++
#end