#domain
hospital2
#levelname
6_Basic_Easy_3
#colors
Purple:0,A,B,C,D,E
#initial
+++++++++++++++
+          B  +
+             +
+ 0           +
+           C +
+          D  +
+             +
+        E    +
+    A        +
+++++++++++++++
#goal
+++++++++++++++
+             +
+             +
+      0  D   +
+        B    +
+   C      E  +
+             +
+        A    +
+             +
+++++++++++++++
#end
