#domain
hospital2
#levelname
0_Basic_Medium_2
#colors
Red:0,1,A,B,C,D,E
#initial
+++++++++++++++
+            E+
+             +
+B  A  D      +
+       0   C +
+             +
+         1   +
+++++++++++++++
#goal
+++++++++++++++
+    0        +
+             +
+       A   C +
+     D       +
+             +
+    E B  1   +
+++++++++++++++
#end
