#domain
hospital2
#levelname
1_Basic_Medium_2
#colors
Orange:0,1,A,B,C,D,E
#initial
+++++++++++++++
+  E          +
+             +
+  B      0   +
+             +
+ 1           +
+ A    D  C   +
+++++++++++++++
#goal
+++++++++++++++
+ E    D      +
+   C         +
+   0         +
+    B        +
+     A       +
+     1       +
+++++++++++++++
#end
