#domain
hospital2
#levelname
3_Basic_Medium_2
#colors
Green:0,1,A,B,C,D,E
#initial
+++++++++++++++
+   E         +
+      0B     +
+    C  D     +
+             +
+  A          +
+ 1           +
+++++++++++++++
#goal
+++++++++++++++
+ AC E        +
+       D     +
+        0    +
+             +
+             +
+1      B     +
+++++++++++++++
#end
