#domain
hospital2
#levelname
4_Basic_Medium_2
#colors
Lightblue:0,1,A,B,C,D,E
#initial
+++++++++++++++
+          1 E+
+   A        D+
+       B C   +
+             +
+         0   +
+             +
+++++++++++++++
#goal
+++++++++++++++
+ C         0 +
+             +
+     D A1    +
+             +
+B     E      +
+             +
+++++++++++++++
#end
