#domain
hospital2
#levelname
0_Dungeon_Medium_2
#colors
Lightblue:0,1,A,B,C,D,E
#initial
+++++++++++++++
++++++++++1  ++
++++++     0  +
+  ++ E++++++ +
+DA  C +++++  +
+++++++++  +  +
+++++++++ B   +
+++++++++++++++
#goal
+++++++++++++++
++++++++++ 1 ++
++++++      0 +
+CA++B ++++++ +
+     D+++++  +
+++++++++  +  +
+++++++++E    +
+++++++++++++++
#end
