#domain
hospital2
#levelname
1_Dungeon_Medium_2
#colors
Lightblue:0,1,A,B,C,D,E
#initial
+++++++++++++++
+++  +  1 +++++
++  E+ 0  +++++
++ +++++ +++ D+
+  +++      B +
+C    A  ++++++
+++++++++++++++
+++++++++++++++
#goal
+++++++++++++++
+++  +    +++++
++ AC+  10+++++
++ +++++ +++ D+
+E +++        +
+B       ++++++
+++++++++++++++
+++++++++++++++
#end
