#domain
hospital2
#levelname
2_Dungeon_Medium_2
#colors
Green:0,1,A,B,C,D,E
#initial
+++++++++++++++
+++++   +++  A+
+++++ D     BC+
+++++ +++++++++
+++++ +++++++++
+++   0+ E ++++
+++ 1      ++++
+++++++++++++++
#goal
+++++++++++++++
+++++  D+++E C+
+++++      BA +
+++++ +++++++++
+++++ +++++++++
+++    +   ++++
+++1 0     ++++
+++++++++++++++
#end
