#domain
hospital2
#levelname
3_Dungeon_Medium_2
#colors
Green:0,1,A,B,C,D,E
#initial
+++++++++++++++
+++++++++++++++
+D  +++++++++++
+ C ++0   +   +
++      1     +
+ E++++++++++++
+BA++++++++++++
+++++++++++++++
#goal
+++++++++++++++
+++++++++++++++
+  B+++++++++++
+E  ++    +   +
++     1 0    +
+C ++++++++++++
+DA++++++++++++
+++++++++++++++
#end
