#domain
hospital2
#levelname
4_Dungeon_Medium_2
#colors
Cyan:0,1,A,B,C,D,E
#initial
+++++++++++++++
+++++++++++++++
+++++++++++ D +
+AB +++0  +   +
+E  +++1     ++
++ +++++++++  +
++          C +
+++++++++++++++
#goal
+++++++++++++++
+++++++++++++++
+++++++++++A  +
+BDC+++  0+   +
+   +++  1   ++
++ +++++++++  +
++          E +
+++++++++++++++
#end
