#domain
hospital2
#levelname
5_Dungeon_Medium_2
#colors
Orange:0,1,A,B,C,D,E
#initial
+++++++++++++++
+  D+++++++++++
+ BA+  E+++++++
++     C ++   +
++++++++      +
++++++   1+++++
++++++0   +++++
+++++++++++++++
#goal
+++++++++++++++
+B  +++++++++++
+   +   +++++++
++       ++DC +
++++++++   A E+
++++++  0 +++++
++++++  1 +++++
+++++++++++++++
#end
