#domain
hospital2
#levelname
6_Dungeon_Medium_2
#colors
Purple:0,1,A,B,C,D,E
#initial
+++++++++++++++
++++++++0  1+++
++++  ++    +++
++++B  +++ ++++
++++++ +++ ++++
+++++C ++D   ++
+++++E      A++
+++++++++++++++
#goal
+++++++++++++++
++++++++    +++
++++C ++1  0+++
++++ E +++ ++++
++++++ +++ ++++
+++++A ++    ++
+++++BD      ++
+++++++++++++++
#end
