#domain
hospital2
#levelname
7_Dungeon_Medium_2
#colors
Purple:0,1,A,B,C,D,E
#initial
+++++++++++++++
+  ++++++++  ++
+E         D ++
++ ++ 01++++ ++
++      ++++ ++
+AC++++++++   +
+ B++++++++   +
+++++++++++++++
#goal
+++++++++++++++
+  ++++++++ D++
+E         C ++
++ ++  1++++ ++
++   0  ++++ ++
+A ++++++++   +
+ B++++++++   +
+++++++++++++++
#end
