#domain
hospital2
#levelname
8_Dungeon_Medium_2
#colors
Orange:0,1,A,B,C,D,E
#initial
+++++++++++++++
+   ++A +++  ++
+ 10   E     ++
++++++++++++ ++
++++++++++  C++
+++++++   B  ++
+++++++ D++++++
+++++++++++++++
#goal
+++++++++++++++
+ 0 ++A +++  ++
+1     E   D ++
++++++++++++ ++
++++++++++ B ++
+++++++    C ++
+++++++  ++++++
+++++++++++++++
#end
