#domain
hospital2
#levelname
9_Dungeon_Medium_2
#colors
Brown:0,1,A,B,C,D,E
#initial
+++++++++++++++
+++++++++++++++
+B + DE++    ++
+        1  0++
+++++++++++ +++
++++++++   C+++
++++++++   A+++
+++++++++++++++
#goal
+++++++++++++++
+++++++++++++++
+ E+AB ++1   ++
+    D    0  ++
+++++++++++ +++
++++++++    +++
++++++++ C  +++
+++++++++++++++
#end
