#domain
hospital2
0_Basic_Easy_3
#Colors
Pink:0,A,B,C,D,E
#Initial
++++++++++
+      0 +
+  CB    +
+   E    +
+        +
+       D+
+        +
+        +
+ A      +
++++++++++
#Goal
++++++++++
+  A     +
+  0     +
+       C+
+       B+
+        +
+        +
+ D  E   +
+        +
++++++++++

