#domain
hospital2
#levelname
0_Dungeon_Medium_1
#colors
Blue:0,1,A,B
#initial
++++++++
++++++++
+A +++++
+   ++++
++ +++++
+ B+  ++
+   10 +
++++++++
#goal
++++++++
++++++++
+  +++++
+ B ++++
++ +++++
+  + 1++
+A   0 +
++++++++
#end
