#domain
hospital2
#levelname
0_Dungeon_Medium_2
#colors
Brown:0,1,A,B,C,D,E
#initial
+++++++++++++++
++  +++++++  ++
++E  +   0+   +
+++ ++   1   ++
++  A+++++++ ++
++   +++++ D ++
+++       CB ++
+++++++++++++++
#goal
+++++++++++++++
++  +++++++B ++
++ D +    +   +
+++ ++  01   ++
++   +++++++ ++
++   +++++AC ++
+++        E ++
+++++++++++++++
#end
