#domain
hospital2
#levelname
0_RandomWalk_Easy_3
#colors
Brown:0,A,B,C,D,E
#initial
++++++++++
+ D    +++
+     B ++
+     + ++
+  C ++ ++
+   ++++++
+E0 ++++++
+ A ++++++
++ +++++++
++++++++++
#goal
++++++++++
+  B D +++
+      0++
+     + ++
+E A ++ ++
+  C++++++
+   ++++++
+   ++++++
++ +++++++
++++++++++
#end
