#domain
hospital2
#levelname
01
#colors
blue:0,A
#initial
++++++++
+    0A+
+ ++++ +
+ +    +
+ + ++++
+ +    +
+ ++++++
+      +
+      +
+      +
+      +
+      +
+      +
+      +
++++++++
#goal
++++++++
+      +
+ ++++ +
+ +    +
+ + ++++
+ +   0+
+ ++++++
+      +
+      +
+      +
+      +
+      +
+      +
+     A+
++++++++
#end