#domain
hospital2
#levelname
0_RandomWalk_Medium_2
#colors
Red:0,1,A,B,C,D,E
#initial
+++++++++++++++
++    +++++++++
++  ++  +++++++
+  E 0   ++++++
+    +   ++++++
+ B  A  D++++++
+  1  C  ++++++
+++++++++++++++
#goal
+++++++++++++++
++ E0 +++++++++
++B ++  +++++++
+     D  ++++++
+   A+   ++++++
+1       ++++++
+   C    ++++++
+++++++++++++++
#end
