#domain
hospital2
#levelname
1_RandomWalk_Medium_2
#colors
Lightblue:0,1,A,B,C,D,E
#initial
+++++++++++++++
++++    +++++++
++++  +++++++++
+++  0  +++++++
+   A 1 E++++++
+C B       ++++
+   D      ++++
+++++++++++++++
#goal
+++++++++++++++
++++A   +++++++
++++  +++++++++
+++     +++++++
+C    E  ++++++
+0  1B D   ++++
+          ++++
+++++++++++++++
#end
