#domain
hospital2
#levelname
2_RandomWalk_Medium_2
#colors
Lightblue:0,1,A,B,C,D,E
#initial
+++++++++++++++
+   + 0 +++++++
+   A B +++++++
+C     E ++++++
+ ++++ D  +++++
+   ++     ++++
++  ++1   +++++
+++++++++++++++
#goal
+++++++++++++++
+ 1D+   +++++++
+     B +++++++
+    E   ++++++
+0++++ AC +++++
+   ++     ++++
++  ++    +++++
+++++++++++++++
#end
