#domain
hospital2
#levelname
3_RandomWalk_Medium_2
#colors
Orange:0,1,A,B,C,D,E
#initial
+++++++++++++++
+++++  + ++++++
+++++  + ++++++
+C+ +    ++++++
+    A1++++++++
++   D +  0  ++
+E        B+ ++
+++++++++++++++
#goal
+++++++++++++++
+++++  + ++++++
+++++  + ++++++
+ + +    ++++++
+A 0   ++++++++
++E    +   D ++
+  B  1C   + ++
+++++++++++++++
#end
