#domain
hospital2
#levelname
4_RandomWalk_Medium_2
#colors
Lightblue:0,1,A,B,C,D,E
#initial
+++++++++++++++
++++  1B+ EC+++
++++      D   +
+++   +  +  A +
+++         +++
+++  ++++++  0+
++++++++++++  +
+++++++++++++++
#goal
+++++++++++++++
++++    +   +++
++++  A  C    +
+++   + E+  D +
+++      0B +++
+++  ++++++  1+
++++++++++++  +
+++++++++++++++
#end
