#domain
hospital2
#levelname
5_RandomWalk_Medium_2
#colors
Lightblue:0,1,A,B,C,D,E
#initial
+++++++++++++++
+         ++ ++
+ C     B  +A++
++ 1  D++     +
++++ + ++++++++
++++E  ++++++++
++++0  ++++++++
+++++++++++++++
#goal
+++++++++++++++
+   C     ++ ++
+          +D++
++ 1   ++     +
++++ +A++++++++
++++B  ++++++++
++++E 0++++++++
+++++++++++++++
#end
