#domain
hospital2
#levelname
6_RandomWalk_Medium_2
#colors
Orange:0,1,A,B,C,D,E
#initial
+++++++++++++++
+     1    ++++
++D      B ++++
+ 0       A++++
+  ++ CE+++++++
+++++ +++++++++
++    +++++++++
+++++++++++++++
#goal
+++++++++++++++
+   B      ++++
++       E0++++
+ D A  C   ++++
+1 ++   +++++++
+++++ +++++++++
++    +++++++++
+++++++++++++++
#end
