#domain
hospital2
#levelname
7_RandomWalk_Medium_2
#colors
Green:0,1,A,B,C,D,E
#initial
+++++++++++++++
++ ++++++++++++
++    +++++++++
+    C+ +++++++
+   BD  +++ +++
+A  E       +++
+    0  + 1++++
+++++++++++++++
#goal
+++++++++++++++
++ ++++++++++++
++    +++++++++
+1    + +++++++
+ 0A   C+++ +++
+ B        D+++
+       +E ++++
+++++++++++++++
#end
