#domain
hospital2
#levelname
8_RandomWalk_Medium_2
#colors
Blue:0,1,A,B,C,D,E
#initial
+++++++++++++++
+ 0     +++++++
+ E D  C+++++++
+ B +  A ++++++
+   +1   ++++++
++  +      ++++
+++ +++ ++ ++++
+++++++++++++++
#goal
+++++++++++++++
+    0  +++++++
+ C BA  +++++++
+E  +    ++++++
+D  +    ++++++
++  + 1    ++++
+++ +++ ++ ++++
+++++++++++++++
#end
