#domain
hospital2
#levelname
9_RandomWalk_Medium_2
#colors
Purple:0,1,A,B,C,D,E
#initial
+++++++++++++++
+  E +++  C  ++
+++D1 B  ++  ++
++     +++++  +
+        +++  +
+  0++   ++++++
++++++ A ++++++
+++++++++++++++
#goal
+++++++++++++++
+   E+++     ++
+++     B++1 ++
++     +++++  +
+ A    D +++0 +
+   ++  C++++++
++++++   ++++++
+++++++++++++++
#end
