#domain
hospital2
#levelname
0_Dungeon_Easy_2
#colors
Lightblue:0,A,B,C
#initial
++++++++++
++++++++++
++++++++++
+ C+++0 ++
+AB     ++
++++++++++
++++++++++
++++++++++
#goal
++++++++++
++++++++++
++++++++++
+AB+++0 ++
+C      ++
++++++++++
++++++++++
++++++++++
#end
