#domain
hospital2
#levelname
1_Dungeon_Easy_2
#colors
Brown:0,A,B,C
#initial
++++++++++
++++++++++
+++AC+++++
+++ B++  +
++++   0 +
+++  +++++
+++  +++++
++++++++++
#goal
++++++++++
++++++++++
+++  +++++
+++CA++  +
++++    0+
+++ B+++++
+++  +++++
++++++++++
#end
