#domain
hospital2
#levelname
2_Dungeon_Easy_2
#colors
Purple:0,A,B,C
#initial
++++++++++
+  +++++++
+BA++++  +
++ +0 +  +
++ +     +
++ ++++  +
++     C +
++++++++++
#goal
++++++++++
+  +++++++
+C ++++  +
++ + 0+AB+
++ +     +
++ ++++  +
++       +
++++++++++
#end
