#domain
hospital2
#levelname
3_Dungeon_Easy_2
#colors
Green:0,A,B,C
#initial
++++++++++
++  ++++++
++    A ++
++ +++CB++
++ +++++++
+  +0 ++++
+     ++++
++++++++++
#goal
++++++++++
++  ++++++
++    A ++
++ +++B ++
++ +++++++
+  + 0++++
+ C   ++++
++++++++++
#end
