#domain
hospital2
#levelname
4_Dungeon_Easy_2
#colors
Green:0,A,B,C
#initial
++++++++++
++++  ++++
++++ A   +
+++++ +  +
+  ++ +  +
+0   B++++
++++C ++++
++++++++++
#goal
++++++++++
++++ A++++
++++B    +
+++++ +  +
+0 ++ + C+
+     ++++
++++  ++++
++++++++++
#end
