#domain
hospital2
#levelname
5_Dungeon_Easy_2
#colors
Blue:0,A,B,C
#initial
++++++++++
+  +++++++
+  +0 ++++
++    ++++
+C ++++ B+
+      A +
++++++++++
++++++++++
#goal
++++++++++
+B +++++++
+A +0 ++++
++    ++++
+C ++++  +
+        +
++++++++++
++++++++++
#end
