#domain
hospital2
#levelname
6_Dungeon_Easy_2
#colors
Lightblue:0,A,B,C
#initial
++++++++++
+++++++A +
+++ 0++ C+
+++  +++ +
++++ +++ +
+++  ++  +
+++    B +
++++++++++
#goal
++++++++++
+++++++  +
+++  ++ B+
+++ 0+++ +
++++ +++ +
+++ A++  +
+++C     +
++++++++++
#end
