#domain
hospital2
#levelname
7_Dungeon_Easy_2
#colors
Cyan:0,A,B,C
#initial
++++++++++
+++++++  +
++  +++ B+
++ 0++++ +
+++ +++  +
+++   +C +
+++ A    +
++++++++++
#goal
++++++++++
+++++++  +
++ 0+++  +
++  ++++ +
+++ +++ A+
+++ B +  +
+++ C    +
++++++++++
#end
