#domain
hospital2
#levelname
8_Dungeon_Easy_2
#colors
Brown:0,A,B,C
#initial
++++++++++
+ B++  +++
+      +++
++++ +++++
+++  +  ++
+++AC  0++
++++++++++
++++++++++
#goal
++++++++++
+AB++  +++
+    C +++
++++ +++++
+++  +0 ++
+++     ++
++++++++++
++++++++++
#end
