#domain
hospital2
#levelname
9_Dungeon_Easy_2
#colors
Blue:0,A,B,C
#initial
++++++++++
+ A+++++++
+  +0 ++++
++ +  ++++
++ ++ ++++
++  C   ++
++  B   ++
++++++++++
#goal
++++++++++
+  +++++++
+C + 0++++
++ +  ++++
++ ++ ++++
++  A   ++
++    B ++
++++++++++
#end
