#domain
hospital2
#levelname
2_Basic_Easy_2
#colors
Cyan:0,A,B,C
#initial
++++++++++
+        +
+        +
+C       +
+        +
+       0+
+ A  B   +
++++++++++
#goal
++++++++++
+        +
+        +
+    0   +
+       A+
+        +
+   B  C +
++++++++++
#end
