#domain
hospital2
#levelname
6_Basic_Easy_2
#colors
Lightblue:0,A,B,C
#initial
++++++++++
+        +
+    B   +
+       0+
+        +
+A       +
+C       +
++++++++++
#goal
++++++++++
+        +
+        +
+C    A  +
+        +
+        +
+  B 0   +
++++++++++
#end
