#domain
hospital2
#levelname
0_RandomWalk_Easy_3
#colors
Green:0,A,B,C,D,E
#initial
+++++++++++++++
+++++++       +
+++++ E       +
+++++         +
++++  C  D   B+
++++       ++A+
++++       ++++
+++++  0   ++++
++++++++++ ++++
+++++++++++++++
#goal
+++++++++++++++
+++++++ 0     +
+++++         +
+++++         +
++++    E     +
++++ C     ++ +
++++       ++++
+++++A  D B++++
++++++++++ ++++
+++++++++++++++
#end
