#domain
hospital2
#levelname
1_RandomWalk_Easy_3
#colors
Red:0,A,B,C,D,E
#initial
+++++++++++++++
++++0       +++
+++E+       +++
++ B A      +++
++   +    +++++
++++C+ D    +++
++++++++    +++
++++++++    +++
++++++++    +++
+++++++++++++++
#goal
+++++++++++++++
++++  0     +++
+++ +    E  +++
++  C       +++
++ A +    +++++
++++ +      +++
++++++++  B +++
++++++++    +++
++++++++D   +++
+++++++++++++++
#end
