#domain
hospital2
#levelname
2_RandomWalk_Easy_3
#colors
Lightblue:0,A,B,C,D,E
#initial
+++++++++++++++
+++++++++++++++
++++ ++++++++++
++++   ++ ++ ++
++++      ++ ++
+      CE     +
+             +
+  +0D B A ++++
++++++  +  ++++
+++++++++++++++
#goal
+++++++++++++++
+++++++++++++++
++++ ++++++++++
++++   ++ ++ ++
++++      ++ ++
+ A    C      +
+     0 E     +
+B +  D    ++++
++++++  +  ++++
+++++++++++++++
#end
