#domain
hospital2
#levelname
3_RandomWalk_Easy_3
#colors
Lightblue:0,A,B,C,D,E
#initial
+++++++++++++++
+++B  +++++++++
++ D  +    ++++
++ A ++    ++++
++   +    +++++
++  C ++   ++++
+E0      +  +++
+      ++++++++
+   ++ ++++++++
+++++++++++++++
#goal
+++++++++++++++
+++   +++++++++
++    +    ++++
++   ++    ++++
++E  +B   +++++
++    ++C  ++++
+        + 0+++
+ A    ++++++++
+ D ++ ++++++++
+++++++++++++++
#end
