#domain
hospital2
#levelname
4_RandomWalk_Easy_3
#colors
Pink:0,A,B,C,D,E
#initial
+++++++++++++++
+++++++++++++++
+++++++++++++++
+   E        ++
+       D    ++
+ C     + +  ++
+      B  +++++
+     0 +++++++
+  A   ++++++++
+++++++++++++++
#goal
+++++++++++++++
+++++++++++++++
+++++++++++++++
+            ++
+          B ++
+       + +  ++
+D   EA   +++++
+      C+++++++
+0     ++++++++
+++++++++++++++
#end
