#domain
hospital2
#levelname
5_RandomWalk_Easy_3
#colors
Orange:0,A,B,C,D,E
#initial
+++++++++++++++
+ B++++ +++++++
++  +    ++++++
+     +++++++++
+      ++++++++
+ A    0+  ++++
+E          +++
+       +++ +++
+   C  D+++++++
+++++++++++++++
#goal
+++++++++++++++
+  ++++ +++++++
++  +  D ++++++
+     +++++++++
+   0A ++++++++
+ E  B  +  ++++
+           +++
+ C     +++ +++
+       +++++++
+++++++++++++++
#end
