#domain
hospital2
#levelname
6_RandomWalk_Easy_3
#colors
Green:0,A,B,C,D,E
#initial
+++++++++++++++
++++    +++  ++
+++   +  +  A++
+++   +    C ++
+++   ++     ++
+++   +  0+++++
+++  D     ++++
+++     E +++++
++++  B  ++++++
+++++++++++++++
#goal
+++++++++++++++
++++    +++  ++
+++   +  +   ++
+++   +      ++
+++   ++     ++
+++   +   +++++
+++ E B    ++++
+++     A0+++++
++++   CD++++++
+++++++++++++++
#end
