#domain
hospital2
#levelname
7_RandomWalk_Easy_3
#colors
Red:0,A,B,C,D,E
#initial
+++++++++++++++
+ A      ++++++
+        ++++++
+       E +++++
+D+  CB++++++++
+ +    ++++++++
+       +++++++
+    ++ 0  ++++
+ +++++++ +++++
+++++++++++++++
#goal
+++++++++++++++
+D  B    ++++++
+0       ++++++
+         +++++
+ +    ++++++++
+ +    ++++++++
+       +++++++
+   C++  A ++++
+ +++++++E+++++
+++++++++++++++
#end
