#domain
hospital2
#levelname
8_RandomWalk_Easy_3
#colors
Red:0,A,B,C,D,E
#initial
+++++++++++++++
++    ++++    +
++     + + A  +
+  +   B     ++
+  +      +  ++
++++ +D   +++++
++++ C ++ 0 +++
+++++E ++++++++
+++++++++++++++
+++++++++++++++
#goal
+++++++++++++++
++   D++++    +
++     + +    +
+  +AE   C   ++
+  +      +  ++
++++ +    +++++
++++ B0++   +++
+++++  ++++++++
+++++++++++++++
+++++++++++++++
#end
