#domain
hospital2
#levelname
9_RandomWalk_Easy_3
#colors
Red:0,A,B,C,D,E
#initial
+++++++++++++++
+++ 0++      ++
+++ A         +
+++ ++ B      +
+++ ++      +++
++  ++++ C E+++
+  ++  D ++++++
+++++ +  ++++++
++++  +++++++++
+++++++++++++++
#goal
+++++++++++++++
+++  ++  A  D++
+++E0        B+
+++ ++        +
+++ ++  C   +++
++  ++++    +++
+  ++    ++++++
+++++ +  ++++++
++++  +++++++++
+++++++++++++++
#end
