#domain
hospital2
#levelname
02
#colors
Blue:0,A
#initial
++++++++++
+0A      +
+ ++++++ +
+      + +
+      + +
+      + +
+      + +
+      + +
+      + +
++++++++++
#goal
++++++++++
+        +
+ ++++++ +
+      + +
+      + +
+      + +
+      + +
+      + +
+      +A+
++++++++++
#end