#domain
hospital2
#levelname
0_Dungeon_Medium_1
#colors
Blue:0,1,A,B
#initial
++++++++
+  +++++
+      +
++ ++ B+
+  ++ A+
+01+++++
++++++++
++++++++
#goal
++++++++
+  +++++
+      +
++ ++  +
+ 0++AB+
+1 +++++
++++++++
++++++++
#end
