#domain
hospital2
#levelname
1_Dungeon_Medium_1
#colors
Red:0,1,A,B
#initial
++++++++
+++++B +
+++++  +
++++++ +
++  + A+
++10   +
++++++++
++++++++
#goal
++++++++
+++++B +
+++++A +
++++++ +
++1 +  +
++0    +
++++++++
++++++++
#end
