#domain
hospital2
#levelname
4_Dungeon_Medium_1
#colors
Red:0,1,A,B
#initial
++++++++
++++A ++
++++  ++
+ 0++ ++
+1    ++
++++  ++
++++B ++
++++++++
#goal
++++++++
++++ A++
++++ B++
+ 1++ ++
+ 0   ++
++++  ++
++++  ++
++++++++
#end
