#domain
hospital2
#levelname
5_Dungeon_Medium_1
#colors
Cyan:0,1,A,B
#initial
++++++++
++++++++
+  +++++
+   A ++
++ +B ++
+1 +++++
+ 0+++++
++++++++
#goal
++++++++
++++++++
+  +++++
+   AB++
++ +  ++
+ 1+++++
+0 +++++
++++++++
#end
