#domain
hospital2
#levelname
6_Dungeon_Medium_1
#colors
Blue:0,1,A,B
#initial
++++++++
+++  +++
+++01+++
++++ +++
++++   +
+ B    +
+A +++++
++++++++
#goal
++++++++
+++0 +++
+++ 1+++
++++ +++
++++ A +
+      +
+ B+++++
++++++++
#end
