#domain
hospital2
#levelname
7_Dungeon_Medium_1
#colors
Red:0,1,A,B
#initial
++++++++
++++  ++
++++ B++
+++++ ++
+ 0+A ++
+1    ++
++++++++
++++++++
#goal
++++++++
++++ A++
++++  ++
+++++ ++
+10+ B++
+     ++
++++++++
++++++++
#end
