#domain
hospital2
#levelname
8_Dungeon_Medium_1
#colors
Green:0,1,A,B
#initial
++++++++
++++++++
++++++++
+++1B+++
+++0A+++
++++++++
++++++++
++++++++
#goal
++++++++
++++++++
++++++++
+++BA+++
+++01+++
++++++++
++++++++
++++++++
#end
