#domain
hospital2
#levelname
0_Dungeon_Easy_3
#colors
Lightblue:0,A,B,C,D,E
#initial
+++++++++++++++
+++++++++++++++
+++++++++DE  ++
++    +++    ++
++           ++
++  0 +++++ +++
++++++++++AC ++
++++++++++ B ++
++++++++++   ++
+++++++++++++++
#goal
+++++++++++++++
+++++++++++++++
+++++++++C   ++
++ 0  +++A B ++
++        D  ++
++    +++++ +++
++++++++++ E ++
++++++++++   ++
++++++++++   ++
+++++++++++++++
#end
