#domain
hospital2
#levelname
1_Dungeon_Easy_3
#colors
Brown:0,A,B,C,D,E
#initial
+++++++++++++++
+++++++   B++++
+++++++  A  +++
+++++++     +++
+++++++++++ +++
+++++++++    ++
+++ D +++  0 ++
+++C         ++
+++E  +++++++++
+++++++++++++++
#goal
+++++++++++++++
+++++++ E  ++++
+++++++     +++
+++++++     +++
+++++++++++ +++
+++++++++    ++
+++ C +++   0++
+++  D       ++
+++BA +++++++++
+++++++++++++++
#end
