#domain
hospital2
#levelname
2_Dungeon_Easy_3
#colors
Lightblue:0,A,B,C,D,E
#initial
+++++++++++++++
+++++++++++++++
++++++++++C  ++
++++++++++ B ++
++   0++++  A++
++    +++++ +++
++    +     +++
++++   E D  +++
+++++++    ++++
+++++++++++++++
#goal
+++++++++++++++
+++++++++++++++
++++++++++ A ++
++++++++++B D++
++ 0  ++++   ++
++    +++++ +++
++    +     +++
++++    C   +++
+++++++  E ++++
+++++++++++++++
#end
