#domain
hospital2
#levelname
3_Dungeon_Easy_3
#colors
Pink:0,A,B,C,D,E
#initial
+++++++++++++++
+++++++   +++++
+++++++B C   ++
+++++++ D ++ ++
+ 0  +++ ++   +
+      E  +   +
+    ++   +A  +
+++++++   +++++
+++++++++++++++
+++++++++++++++
#goal
+++++++++++++++
+++++++   +++++
+++++++      ++
+++++++BD ++ ++
+    +++ ++ C +
+  0      +   +
+    ++  E+ A +
+++++++   +++++
+++++++++++++++
+++++++++++++++
#end
