#domain
hospital2
#levelname
4_Dungeon_Easy_3
#colors
Orange:0,A,B,C,D,E
#initial
+++++++++++++++
+++++++++++++++
++ 0  +++    ++
++    +++    ++
++    +++D   ++
++++ ++++++ +++
++E  ++++++ +++
++  A       +++
++B C++++++++++
+++++++++++++++
#goal
+++++++++++++++
+++++++++++++++
++    +++D A ++
++ 0  +++ EC ++
++    +++    ++
++++ ++++++ +++
++B  ++++++ +++
++          +++
++   ++++++++++
+++++++++++++++
#end
