#domain
hospital2
#levelname
5_Dungeon_Easy_3
#colors
Purple:0,A,B,C,D,E
#initial
+++++++++++++++
+++C E++++    +
+++  A++++  0 +
+++ B ++++    +
++++ +++++++ ++
++++ +++++++ ++
+    +++++++ ++
+            ++
+  D ++++++++++
+++++++++++++++
#goal
+++++++++++++++
+++ C ++++    +
+++   ++++    +
+++ B ++++ 0  +
++++ +++++++ ++
++++ +++++++ ++
+   E+++++++ ++
+            ++
+  AD++++++++++
+++++++++++++++
#end
