#domain
hospital2
#levelname
6_Dungeon_Easy_3
#colors
Cyan:0,A,B,C,D,E
#initial
+++++++++++++++
+++++++++++++++
++++0   +++++++
++++    ++   ++
++++       C ++
++++++ +++  D++
++   +EA ++++++
++    B  ++++++
++   +   ++++++
+++++++++++++++
#goal
+++++++++++++++
+++++++++++++++
++++    +++++++
++++   0++ DC++
++++      E  ++
++++++ +++AB ++
++   +   ++++++
++       ++++++
++   +   ++++++
+++++++++++++++
#end
