#domain
hospital2
#levelname
7_Dungeon_Easy_3
#colors
Blue:0,A,B,C,D,E
#initial
+++++++++++++++
+++++++++++++++
+++++++    ++++
++B        ++++
++DA ++    ++++
++CE +++ ++++++
++++++ 0  +++++
++++++    +++++
++++++    +++++
+++++++++++++++
#goal
+++++++++++++++
+++++++++++++++
+++++++    ++++
++ C     D ++++
++  A++    ++++
++EB +++ ++++++
++++++    +++++
++++++    +++++
++++++0   +++++
+++++++++++++++
#end
