#domain
hospital2
#levelname
8_Dungeon_Easy_3
#colors
Blue:0,A,B,C,D,E
#initial
+++++++++++++++
++++ A ++++++++
++++D C ++    +
++++    ++  0 +
+++++++ ++    +
++++++   +++ ++
++++++  B+   ++
++++++  E    ++
++++++++++   ++
+++++++++++++++
#goal
+++++++++++++++
++++ A ++++++++
++++    ++ 0  +
++++    ++    +
+++++++ ++    +
++++++ C +++ ++
++++++   +D  ++
++++++E      ++
++++++++++B  ++
+++++++++++++++
#end
