#domain
hospital2
#levelname
9_Dungeon_Easy_3
#colors
Purple:0,A,B,C,D,E
#initial
+++++++++++++++
+++++++++C   ++
+++++++++ E D++
+++++++++A   ++
+++    ++++ +++
+++         B++
+++  0 +++   ++
++++++++++   ++
+++++++++++++++
+++++++++++++++
#goal
+++++++++++++++
+++++++++    ++
+++++++++    ++
+++++++++    ++
+++    ++++ +++
+++   0   EB ++
+++    +++ DA++
++++++++++ C ++
+++++++++++++++
+++++++++++++++
#end
