#domain
hospital2
#levelname
8_RandomWalk_Medium_1
#colors
Green:0,1,A,B
#initial
++++++++
++  ++++
+   A+++
+ 1 ++++
+  B++++
+ 0  +++
+  +++++
++++++++
#goal
++++++++
++ 0++++
+    +++
+A  ++++
+1  ++++
+    +++
+ B+++++
++++++++
#end
