#domain
hospital2
#levelname
9_RandomWalk_Medium_1
#colors
Red:0,1,A,B
#initial
++++++++
++++++++
++++++ +
+++++  +
+++ 1A0+
+   B  +
++     +
++++++++
#goal
++++++++
++++++++
++++++ +
+++++0 +
+++ BA +
+      +
++ 1   +
++++++++
#end
