#domain
hospital2
#levelname
6_Basic_Medium_1
#colors
Red:0,1,A,B
#initial
++++++++
+     1+
+      +
+      +
+      +
+    A0+
+   B  +
++++++++
#goal
++++++++
+    1 +
+    A0+
+  B   +
+      +
+      +
+      +
++++++++
#end
