#domain
hospital2
#levelname
7_Basic_Medium_1
#colors
Red:0,1,A,B
#initial
++++++++
+      +
+   A  +
+      +
+      +
+ 0   B+
+ 1    +
++++++++
#goal
++++++++
+      +
+1     +
+      +
+    A +
+     0+
+ B    +
++++++++
#end
