#domain
hospital2
#levelname
8_Basic_Medium_1
#colors
Lightblue:0,1,A,B
#initial
++++++++
+1     +
+     0+
+      +
+      +
+  A  B+
+      +
++++++++
#goal
++++++++
+   0A +
+      +
+   B 1+
+      +
+      +
+      +
++++++++
#end
