#domain
hospital2
#levelname
0_RandomWalk_Easy_2
#colors
Green:0,A,B,C
#initial
++++++++++
++++     +
+++   AB++
+++0     +
+++ ++  ++
+++ ++ C++
+++ +   ++
++++++++++
#goal
++++++++++
++++ C   +
+++ 0   ++
+++  A B +
+++ ++  ++
+++ ++  ++
+++ +   ++
++++++++++
#end
