#domain
hospital2
#levelname
1_RandomWalk_Easy_2
#colors
Orange:0,A,B,C
#initial
++++++++++
+C AB ++++
+     ++++
+     ++++
+    +++++
+++0  ++++
++++  ++++
++++++++++
#goal
++++++++++
+  B A++++
+     ++++
+     ++++
+  0 +++++
+++  C++++
++++  ++++
++++++++++
#end
