#domain
hospital2
#levelname
2_RandomWalk_Easy_2
#colors
Green:0,A,B,C
#initial
++++++++++
+  ++  +++
+   A  +++
++ C    ++
++ B 0++++
++    ++++
++++++++++
++++++++++
#goal
++++++++++
+B ++  +++
+C0    +++
++      ++
++    ++++
++  A ++++
++++++++++
++++++++++
#end
