#domain
hospital2
#levelname
3_RandomWalk_Easy_2
#colors
Blue:0,A,B,C
#initial
++++++++++
+++   ++++
+  C0A++++
+   B ++++
++    ++++
++    ++++
++  + ++++
++++++++++
#goal
++++++++++
+++  C++++
+     ++++
+A   0++++
++ B  ++++
++    ++++
++  + ++++
++++++++++
#end
