#domain
hospital2
#levelname
4_RandomWalk_Easy_2
#colors
Lightblue:0,A,B,C
#initial
++++++++++
+   ++++++
+   C++ ++
+ A     ++
++ ++  0++
++ +++  ++
++++++ B++
++++++++++
#goal
++++++++++
+   ++++++
+C  A++ ++
+ 0     ++
++ ++   ++
++ +++  ++
++++++ B++
++++++++++
#end
