#domain
hospital2
#levelname
5_RandomWalk_Easy_2
#colors
Purple:0,A,B,C
#initial
++++++++++
++++++++++
++++++++++
+++0+  +++
+   +   A+
+C    ++ +
+   B    +
++++++++++
#goal
++++++++++
++++++++++
++++++++++
+++ +  +++
+   +    +
+ B  0++ +
+     CA +
++++++++++
#end
