#domain
hospital2
#levelname
6_RandomWalk_Easy_2
#colors
Orange:0,A,B,C
#initial
++++++++++
+  0     +
+ B      +
++ A++  ++
+++  +++++
++++ +++++
++++C+++++
++++++++++
#goal
++++++++++
+ A      +
+      C +
++  ++  ++
+++ B+++++
++++ +++++
++++0+++++
++++++++++
#end
