#domain
hospital2
#levelname
7_RandomWalk_Easy_2
#colors
Orange:0,A,B,C
#initial
++++++++++
++++++++++
+++ AB +++
+   0 ++++
+     ++++
+     ++++
+   C  +++
++++++++++
#goal
++++++++++
++++++++++
+++    +++
+ B   ++++
+ A   ++++
+ 0   ++++
+     C+++
++++++++++
#end
