#domain
hospital2
#levelname
8_RandomWalk_Easy_2
#colors
Blue:0,A,B,C
#initial
++++++++++
+++ 0+   +
++++    C+
++++++   +
++++++ AB+
+++++    +
+++++    +
++++++++++
#goal
++++++++++
+++  +   +
++++C    +
++++++  A+
++++++   +
+++++    +
+++++0B  +
++++++++++
#end
